OOOOOOOOOO
O O    O O
O . OO   O
O O O   XO
O OOOO O.O
O O O    U
